1 1 1 0 0 1 1 1 1 1 1 1
0 0 2 2 2 2 0 0 0 2 2 0
6 1 1 1 0 4 2 2 1 0 0 2
5 2 0 2 5 2 0 2 5 2 5 2
0 0 5 2 2 0 0 2 2 2 2 2
1 2 2 1 0 0 3 2 2 3 5 5
3 6 6 3 2 2 2 2 2 2 0 0
2 3 3 2 0 0 0 4 5 5 4 2
0 0 6 1 1 1 1 1 2 2 5 0
2 6 0 0 0 0 0 2 2 5 5 2
0 4 2 2 2 4 0 0 3 2 2 3
5 5 0 0 0 2 1 1 1 2 0 6
